R 640 480

F 220,100,0
C 225,30,255

NO ./textures/cubblestone.xpm
SO ./textures/grey_brick.xpm
WE ./textures/red_brick.xpm
EA ./textures/wood.xpm

S ./textures/barrel.xpm

 1111111111111111111111111111
100000002000000000000001000001
100000000000000000000000000001
111001111111111111111111000001
100000000000001022222221110111
100000000000001022222221000001
10000000000000102222222100N001
100000000000000022222221000001
 1111111111111111111111111111